Name,Math,Science,English,Total,Percentage,Grade
Amit,78,88,94,260,86.66666666666667,A
Neha,65,70,80,215,71.66666666666667,B
Rahul,90,95,85,270,90.0,A+
Priya,55,60,58,173,57.666666666666664,C
Suresh,85,78,82,245,81.66666666666667,A
Anjali,92,89,94,275,91.66666666666666,A+
Karan,60,75,68,203,67.66666666666666,B
Pooja,72,84,77,233,77.66666666666666,A
Vikram,88,90,91,269,89.66666666666666,A
Divya,67,73,79,219,73.0,B
